10 10 10 10 10 10 10 10 10 10 10 10 10 10 10 10 10 10 10 10 10 10 10 10 10 10 10 10 10 10
50 50 50 50 50 50 50 10 10 10 10 10 10 10 10 50 50 50 50 50 50 50 10 50 50 50 10 11 10 10
50 51 51 51 51 51 50 10 11 10 11 11 10 11 10 50 51 51 51 51 51 50 10 50 51 50 10 10 10 10
50 51 51 51 51 51 50 10 10 10 10 10 10 10 10 50 51 51 51 51 51 50 10 50 54 50 10 10 10 10
50 51 51 50 51 51 50 50 50 50 51 51 50 50 50 50 51 51 50 51 51 50 10 10 10 11 11 10 10 10
50 51 51 51 51 51 51 51 51 51 51 51 51 51 51 51 51 51 51 51 51 50 10 11 11 11 10 10 10 10
50 51 51 51 51 51 50 50 50 50 50 50 50 50 50 50 51 51 51 51 51 50 10 10 10 10 10 10 10 10
50 50 50 50 50 51 50 51 51 51 51 51 51 51 51 50 50 50 53 50 50 50 50 50 51 50 50 50 10 10
50 51 51 51 50 51 50 56 51 51 51 51 51 50 51 50 51 51 51 51 51 51 51 51 51 51 51 50 10 10
50 51 51 51 51 51 50 51 51 51 51 51 51 51 51 50 51 51 51 51 51 51 51 51 51 51 51 50 10 10
50 51 51 51 50 51 50 50 50 51 51 51 51 50 50 50 50 50 50 50 50 50 50 50 50 51 51 50 10 10
50 50 50 50 50 51 50 11 11 51 51 51 51 11 11 50 51 51 50 51 51 50 51 51 50 51 51 50 10 10
50 51 51 51 50 51 50 11 11 51 51 51 51 11 11 50 51 51 50 51 51 50 51 51 50 51 51 50 10 10
50 51 51 51 50 51 50 11 10 51 51 51 51 10 11 50 51 51 51 51 51 51 51 51 51 51 51 50 10 10
50 55 51 51 53 51 50 10 10 51 51 51 51 10 10 50 51 51 51 51 51 51 51 51 51 51 51 50 10 10
50 51 55 51 50 51 50 10 10 51 51 51 51 10 10 50 51 51 50 51 51 50 51 51 50 51 51 50 10 10
50 55 51 55 50 51 50 10 51 51 51 51 51 51 10 50 51 51 50 51 51 50 51 51 50 51 51 50 10 10
50 50 50 50 50 51 50 10 51 21 21 21 21 51 10 50 50 50 50 50 50 50 50 50 50 51 50 50 10 10
50 51 51 51 51 51 51 51 51 21 52 52 21 51 51 51 51 51 51 51 51 50 51 51 51 51 51 50 10 10
50 51 51 51 51 51 51 51 51 21 52 52 21 51 51 51 51 51 51 51 51 50 52 52 52 52 52 50 10 10
50 50 50 51 51 50 50 50 51 21 21 21 21 51 50 50 51 51 51 51 51 50 52 52 52 52 52 50 10 10
50 51 51 51 51 51 51 50 51 51 51 51 51 51 50 51 51 51 51 51 51 50 51 51 51 51 51 50 10 10
50 51 51 51 51 51 51 50 50 51 51 51 51 50 50 50 50 50 50 51 51 50 51 51 51 51 51 50 21 10
50 51 51 50 51 51 51 51 50 51 51 51 51 50 51 51 51 51 51 51 51 50 50 50 50 50 50 50 21 10
50 51 51 51 51 51 51 51 50 51 51 51 51 50 51 51 51 51 51 51 51 50 21 21 21 21 21 21 21 10
50 51 21 21 51 51 50 51 50 51 51 51 51 50 51 51 50 50 50 50 50 50 21 21 21 21 21 21 21 10
50 21 21 21 21 51 51 51 50 51 51 51 51 50 51 51 50 51 51 50 51 50 21 21 21 21 21 21 21 10
50 21 21 21 21 51 51 51 50 50 51 51 50 50 51 51 51 51 51 54 51 50 21 21 21 21 21 21 21 10
50 21 21 21 21 21 51 51 50 51 51 51 51 50 51 51 50 51 51 50 51 50 21 21 21 21 21 21 21 10
50 50 50 50 50 50 50 50 50 50 51 51 50 50 50 50 50 50 50 50 50 50 21 21 21 21 21 21 21 10
21 21 10 10 10 10 10 10 10 10 51 51 10 10 10 10 10 10 10 10 21 21 21 21 21 21 21 21 21 57